1111111111111
1C00P0C0C00C1
101100C000101
10110000011E1
1111111111111