1111111111111111111111111111111111
1E1000000000001C100011011000000011
1010010100100100011000000000010101
1011110010101011101001000000010101
1P00010000C00C00000000000000000001
1111111111111111111111111111111111